
==================================
| IO Statistics                  |
|                                |
| Duration: 298.416668 secs      |
| Interval:   1 secs             |
|                                |
| Col 1: MAX(frame.len)frame.len |
|--------------------------------|
|            |1     |            |
| Interval   |  MAX |            |
|-------------------|            |
|   0 <>   1 | 1484 |            |
|   1 <>   2 | 1392 |            |
|   2 <>   3 | 1484 |            |
|   3 <>   4 | 1484 |            |
|   4 <>   5 | 1392 |            |
|   5 <>   6 | 1392 |            |
|   6 <>   7 | 1392 |            |
|   7 <>   8 | 1392 |            |
|   8 <>   9 | 1392 |            |
|   9 <>  10 | 1392 |            |
|  10 <>  11 | 1484 |            |
|  11 <>  12 | 1392 |            |
|  12 <>  13 |   79 |            |
|  13 <>  14 | 1484 |            |
|  14 <>  15 |    0 |            |
|  15 <>  16 |  343 |            |
|  16 <>  17 | 1484 |            |
|  17 <>  18 | 1392 |            |
|  18 <>  19 | 1019 |            |
|  19 <>  20 | 1392 |            |
|  20 <>  21 | 1015 |            |
|  21 <>  22 | 1392 |            |
|  22 <>  23 |    0 |            |
|  23 <>  24 |  310 |            |
|  24 <>  25 | 1392 |            |
|  25 <>  26 | 1392 |            |
|  26 <>  27 | 1014 |            |
|  27 <>  28 |    0 |            |
|  28 <>  29 | 1020 |            |
|  29 <>  30 |    0 |            |
|  30 <>  31 | 1101 |            |
|  31 <>  32 |  907 |            |
|  32 <>  33 |    0 |            |
|  33 <>  34 | 1392 |            |
|  34 <>  35 |    0 |            |
|  35 <>  36 | 1104 |            |
|  36 <>  37 | 1392 |            |
|  37 <>  38 |   75 |            |
|  38 <>  39 | 1514 |            |
|  39 <>  40 | 1484 |            |
|  40 <>  41 | 1484 |            |
|  41 <>  42 | 1484 |            |
|  42 <>  43 | 1392 |            |
|  43 <>  44 |    0 |            |
|  44 <>  45 | 1392 |            |
|  45 <>  46 | 1392 |            |
|  46 <>  47 | 1392 |            |
|  47 <>  48 | 1392 |            |
|  48 <>  49 | 1392 |            |
|  49 <>  50 |    0 |            |
|  50 <>  51 |    0 |            |
|  51 <>  52 |  179 |            |
|  52 <>  53 |    0 |            |
|  53 <>  54 |    0 |            |
|  54 <>  55 |    0 |            |
|  55 <>  56 |    0 |            |
|  56 <>  57 |    0 |            |
|  57 <>  58 |  781 |            |
|  58 <>  59 |  230 |            |
|  59 <>  60 |    0 |            |
|  60 <>  61 |  349 |            |
|  61 <>  62 |   66 |            |
|  62 <>  63 | 1392 |            |
|  63 <>  64 |    0 |            |
|  64 <>  65 |  702 |            |
|  65 <>  66 |    0 |            |
|  66 <>  67 |    0 |            |
|  67 <>  68 |    0 |            |
|  68 <>  69 | 1392 |            |
|  69 <>  70 |  105 |            |
|  70 <>  71 |  105 |            |
|  71 <>  72 |  310 |            |
|  72 <>  73 |  140 |            |
|  73 <>  74 | 1392 |            |
|  74 <>  75 |   75 |            |
|  75 <>  76 | 1392 |            |
|  76 <>  77 | 1392 |            |
|  77 <>  78 | 1392 |            |
|  78 <>  79 |    0 |            |
|  79 <>  80 |    0 |            |
|  80 <>  81 |    0 |            |
|  81 <>  82 | 1392 |            |
|  82 <>  83 |   42 |            |
|  83 <>  84 |    0 |            |
|  84 <>  85 | 1392 |            |
|  85 <>  86 | 1514 |            |
|  86 <>  87 | 1484 |            |
|  87 <>  88 | 1392 |            |
|  88 <>  89 | 1392 |            |
|  89 <>  90 | 1514 |            |
|  90 <>  91 | 1392 |            |
|  91 <>  92 | 1274 |            |
|  92 <>  93 |  194 |            |
|  93 <>  94 |    0 |            |
|  94 <>  95 | 1392 |            |
|  95 <>  96 | 1392 |            |
|  96 <>  97 | 1392 |            |
|  97 <>  98 | 1392 |            |
|  98 <>  99 |    0 |            |
|  99 <> 100 |    0 |            |
| 100 <> 101 | 1392 |            |
| 101 <> 102 |    0 |            |
| 102 <> 103 |  645 |            |
| 103 <> 104 |  364 |            |
| 104 <> 105 | 1392 |            |
| 105 <> 106 | 1484 |            |
| 106 <> 107 | 1484 |            |
| 107 <> 108 | 1391 |            |
| 108 <> 109 | 1392 |            |
| 109 <> 110 | 1392 |            |
| 110 <> 111 | 1392 |            |
| 111 <> 112 |  381 |            |
| 112 <> 113 |    0 |            |
| 113 <> 114 |  784 |            |
| 114 <> 115 | 1392 |            |
| 115 <> 116 | 1392 |            |
| 116 <> 117 | 1392 |            |
| 117 <> 118 | 1392 |            |
| 118 <> 119 | 1392 |            |
| 119 <> 120 | 1392 |            |
| 120 <> 121 | 1392 |            |
| 121 <> 122 |    0 |            |
| 122 <> 123 |    0 |            |
| 123 <> 124 | 1285 |            |
| 124 <> 125 |    0 |            |
| 125 <> 126 | 1392 |            |
| 126 <> 127 |    0 |            |
| 127 <> 128 | 1070 |            |
| 128 <> 129 | 1392 |            |
| 129 <> 130 | 1392 |            |
| 130 <> 131 |    0 |            |
| 131 <> 132 |  300 |            |
| 132 <> 133 | 1392 |            |
| 133 <> 134 |  230 |            |
| 134 <> 135 | 1392 |            |
| 135 <> 136 |  310 |            |
| 136 <> 137 |    0 |            |
| 137 <> 138 | 1392 |            |
| 138 <> 139 |    0 |            |
| 139 <> 140 | 1392 |            |
| 140 <> 141 |    0 |            |
| 141 <> 142 |    0 |            |
| 142 <> 143 | 1392 |            |
| 143 <> 144 | 1037 |            |
| 144 <> 145 | 1392 |            |
| 145 <> 146 | 1392 |            |
| 146 <> 147 |  301 |            |
| 147 <> 148 | 1392 |            |
| 148 <> 149 | 1392 |            |
| 149 <> 150 | 1263 |            |
| 150 <> 151 |  112 |            |
| 151 <> 152 |   66 |            |
| 152 <> 153 |    0 |            |
| 153 <> 154 |    0 |            |
| 154 <> 155 |   92 |            |
| 155 <> 156 |    0 |            |
| 156 <> 157 |    0 |            |
| 157 <> 158 | 1392 |            |
| 158 <> 159 | 1392 |            |
| 159 <> 160 |    0 |            |
| 160 <> 161 |    0 |            |
| 161 <> 162 |    0 |            |
| 162 <> 163 | 1392 |            |
| 163 <> 164 |  144 |            |
| 164 <> 165 | 1392 |            |
| 165 <> 166 |    0 |            |
| 166 <> 167 |    0 |            |
| 167 <> 168 | 1392 |            |
| 168 <> 169 |    0 |            |
| 169 <> 170 |    0 |            |
| 170 <> 171 | 1392 |            |
| 171 <> 172 | 1392 |            |
| 172 <> 173 | 1392 |            |
| 173 <> 174 | 1392 |            |
| 174 <> 175 | 1392 |            |
| 175 <> 176 |    0 |            |
| 176 <> 177 |    0 |            |
| 177 <> 178 | 1392 |            |
| 178 <> 179 | 1392 |            |
| 179 <> 180 |   75 |            |
| 180 <> 181 |    0 |            |
| 181 <> 182 |    0 |            |
| 182 <> 183 |   92 |            |
| 183 <> 184 |    0 |            |
| 184 <> 185 | 1392 |            |
| 185 <> 186 | 1392 |            |
| 186 <> 187 | 1392 |            |
| 187 <> 188 |    0 |            |
| 188 <> 189 | 1392 |            |
| 189 <> 190 |   99 |            |
| 190 <> 191 | 1283 |            |
| 191 <> 192 | 1214 |            |
| 192 <> 193 | 1085 |            |
| 193 <> 194 | 1392 |            |
| 194 <> 195 | 1392 |            |
| 195 <> 196 | 1392 |            |
| 196 <> 197 |    0 |            |
| 197 <> 198 |    0 |            |
| 198 <> 199 |    0 |            |
| 199 <> 200 |    0 |            |
| 200 <> 201 | 1073 |            |
| 201 <> 202 | 1392 |            |
| 202 <> 203 | 1392 |            |
| 203 <> 204 | 1392 |            |
| 204 <> 205 | 1392 |            |
| 205 <> 206 |  293 |            |
| 206 <> 207 |  599 |            |
| 207 <> 208 | 1392 |            |
| 208 <> 209 |    0 |            |
| 209 <> 210 |    0 |            |
| 210 <> 211 | 1392 |            |
| 211 <> 212 | 1392 |            |
| 212 <> 213 | 1392 |            |
| 213 <> 214 |    0 |            |
| 214 <> 215 | 1392 |            |
| 215 <> 216 |    0 |            |
| 216 <> 217 |    0 |            |
| 217 <> 218 | 1392 |            |
| 218 <> 219 |  956 |            |
| 219 <> 220 | 1484 |            |
| 220 <> 221 | 1392 |            |
| 221 <> 222 |    0 |            |
| 222 <> 223 |    0 |            |
| 223 <> 224 |    0 |            |
| 224 <> 225 | 1484 |            |
| 225 <> 226 | 1484 |            |
| 226 <> 227 |    0 |            |
| 227 <> 228 |    0 |            |
| 228 <> 229 |    0 |            |
| 229 <> 230 |    0 |            |
| 230 <> 231 |    0 |            |
| 231 <> 232 |    0 |            |
| 232 <> 233 |    0 |            |
| 233 <> 234 | 1392 |            |
| 234 <> 235 |  742 |            |
| 235 <> 236 |    0 |            |
| 236 <> 237 |   90 |            |
| 237 <> 238 |   94 |            |
| 238 <> 239 |  230 |            |
| 239 <> 240 |  900 |            |
| 240 <> 241 |    0 |            |
| 241 <> 242 |    0 |            |
| 242 <> 243 |    0 |            |
| 243 <> 244 | 1392 |            |
| 244 <> 245 |   66 |            |
| 245 <> 246 |    0 |            |
| 246 <> 247 |    0 |            |
| 247 <> 248 |    0 |            |
| 248 <> 249 |    0 |            |
| 249 <> 250 | 1392 |            |
| 250 <> 251 |  863 |            |
| 251 <> 252 |    0 |            |
| 252 <> 253 |    0 |            |
| 253 <> 254 | 1392 |            |
| 254 <> 255 | 1392 |            |
| 255 <> 256 |    0 |            |
| 256 <> 257 |    0 |            |
| 257 <> 258 |    0 |            |
| 258 <> 259 |  381 |            |
| 259 <> 260 | 1392 |            |
| 260 <> 261 | 1392 |            |
| 261 <> 262 | 1392 |            |
| 262 <> 263 | 1392 |            |
| 263 <> 264 |    0 |            |
| 264 <> 265 |    0 |            |
| 265 <> 266 |    0 |            |
| 266 <> 267 |    0 |            |
| 267 <> 268 |    0 |            |
| 268 <> 269 |    0 |            |
| 269 <> 270 |    0 |            |
| 270 <> 271 |    0 |            |
| 271 <> 272 |    0 |            |
| 272 <> 273 |    0 |            |
| 273 <> 274 |    0 |            |
| 274 <> 275 |    0 |            |
| 275 <> 276 |    0 |            |
| 276 <> 277 |    0 |            |
| 277 <> 278 |    0 |            |
| 278 <> 279 |    0 |            |
| 279 <> 280 |  139 |            |
| 280 <> 281 |   78 |            |
| 281 <> 282 |   66 |            |
| 282 <> 283 |    0 |            |
| 283 <> 284 |    0 |            |
| 284 <> 285 |  122 |            |
| 285 <> 286 |    0 |            |
| 286 <> 287 |    0 |            |
| 287 <> 288 |    0 |            |
| 288 <> 289 |    0 |            |
| 289 <> 290 | 1392 |            |
| 290 <> 291 |    0 |            |
| 291 <> 292 | 1392 |            |
| 292 <> 293 |   75 |            |
| 293 <> 294 |    0 |            |
| 294 <> 295 |    0 |            |
| 295 <> 296 |    0 |            |
| 296 <> 297 |    0 |            |
| 297 <> 298 |    0 |            |
| 298 <> Dur |  139 |            |
==================================
